######################################################################
#....................................................................#
#....................................................................#
#....................................................................#
#....................................................................#
#.......................#............................................#
#..........###........##............#................................#
#.......................#...........#................................#
#.....................##............#................................#
#.............###########...........#................................#
#...................................#................................#
#...................................#................................#
#...................................#................................#
#...................................#................................#
#...................................##############...................#
#....................................................................#
#....................................................................#
#....................................................................#
#....................................................................#
#....................................................................#
#....................................................................#
#....................................................................#
#....................................................................#
#....................................................................#
#....................................................................#
#....................................................................#
#....................................................................#
#....................................................................#
#....................................................................#
#....................................................................#
#....................................................................#
#....................................................................#
#....................................................................#
#....................................................................#
######################################################################
